04 04 04 04 04 04 04 04 04 04 04 04 04 04 04 04 04 04 04 04 04 04 04 04 04 04 04 04 04 04 04 04 04 04 04 04 04 04 04 04 04 04 04 04 04 04 04 04 04 04
04 04 04 04 04 04 04 04 04 04 04 04 04 04 04 04 04 04 04 04 04 04 04 04 04 04 04 04 04 04 04 04 04 04 04 04 04 04 04 04 04 04 04 04 04 04 04 04 04 04
04 04 04 04 04 04 04 04 04 04 04 04 04 04 04 04 04 04 04 04 04 04 04 04 04 04 04 04 04 04 04 04 04 04 04 04 04 04 04 04 04 04 04 04 04 04 04 04 04 04
04 04 04 04 04 04 04 04 04 04 04 04 04 04 04 04 04 04 04 04 04 04 04 04 04 04 04 04 04 04 04 04 04 04 04 04 04 04 04 04 04 04 04 04 04 04 04 04 04 04
04 04 04 04 04 04 04 04 04 04 04 04 04 04 04 04 04 04 04 04 04 04 04 04 04 04 04 04 04 04 04 04 04 04 04 04 04 04 04 04 04 04 04 04 04 04 04 04 04 04
04 04 04 04 04 04 04 04 08 10 10 10 10 10 10 10 10 10 10 10 10 10 10 10 10 10 10 10 10 10 10 10 10 10 10 10 10 10 10 10 10 09 04 04 04 04 04 04 04 04
04 04 04 04 04 04 04 04 11 03 03 03 03 03 03 03 03 03 03 03 03 03 03 03 03 03 03 03 03 03 03 03 03 03 03 03 03 03 03 03 03 12 04 04 04 04 04 04 04 04
04 04 04 04 04 04 04 04 11 03 00 00 00 00 00 00 00 00 00 00 00 00 00 00 00 00 00 00 00 00 00 00 00 00 00 00 00 00 00 00 03 12 04 04 04 04 04 04 04 04
04 04 04 04 04 04 04 04 11 03 00 00 00 00 00 00 00 00 00 00 00 00 00 00 02 01 00 00 00 00 00 00 00 00 00 00 00 00 00 00 03 12 04 04 04 04 04 04 04 04
04 04 04 04 04 04 04 04 11 03 00 00 00 00 00 00 00 00 00 00 00 00 00 00 02 01 00 00 00 00 00 00 00 00 00 00 00 00 00 00 03 12 04 04 04 04 04 04 04 04
04 04 04 04 04 04 04 04 11 03 00 00 00 00 00 00 00 00 00 00 00 00 00 00 02 01 00 00 00 00 00 00 00 00 00 00 00 00 00 00 03 12 04 04 04 04 04 04 04 04
04 04 04 04 04 04 04 04 11 03 00 00 00 00 00 00 00 00 00 00 00 00 00 00 02 01 00 00 00 00 00 00 00 00 00 00 00 00 00 00 03 12 04 04 04 04 04 04 04 04
04 04 04 04 04 04 04 04 11 03 00 00 00 00 00 00 00 00 00 00 00 00 00 00 02 01 00 00 00 00 00 00 00 00 00 00 00 00 00 00 03 12 04 04 04 04 04 04 04 04
04 04 04 04 04 04 04 04 11 03 00 00 00 00 00 00 00 00 00 00 00 00 00 00 02 01 00 00 00 00 00 00 00 00 00 00 00 00 00 00 03 12 04 04 04 04 04 04 04 04
04 04 04 04 04 04 04 04 11 03 00 00 00 00 00 00 00 00 00 00 00 00 00 00 02 01 00 00 00 00 00 00 00 00 00 00 00 00 00 00 03 12 04 04 04 04 04 04 04 04
04 04 04 04 04 04 04 04 11 03 00 00 00 00 00 00 00 00 00 00 00 00 00 00 02 01 00 00 00 00 00 00 00 00 00 00 00 00 00 00 03 12 04 04 04 04 04 04 04 04
04 04 04 04 04 04 04 04 11 03 00 00 00 00 00 00 00 00 00 00 00 00 00 00 02 01 00 00 00 00 00 00 00 00 00 00 00 00 00 00 03 12 04 04 04 04 04 04 04 04
04 04 04 04 04 04 04 04 11 03 00 00 00 00 00 00 00 00 00 00 00 00 00 00 02 01 00 00 00 00 00 00 00 00 00 00 00 00 00 00 03 12 04 04 04 04 04 04 04 04
04 04 04 04 04 04 04 04 11 03 00 00 00 00 00 00 00 00 00 00 00 00 00 00 02 01 00 00 00 00 00 00 00 00 00 00 00 00 00 00 03 12 04 04 04 04 04 04 04 04
04 04 04 04 04 04 04 04 11 03 00 00 00 00 00 00 00 00 00 00 00 00 00 00 02 01 00 00 00 00 00 00 00 00 00 00 00 00 00 00 03 12 04 04 04 04 04 04 04 04
04 04 04 04 04 04 04 04 11 03 00 00 00 00 00 00 00 00 00 00 00 00 00 00 02 01 00 00 00 00 00 00 00 00 00 00 00 00 00 00 03 12 04 04 04 04 04 04 04 04
04 04 04 04 04 04 04 04 11 03 00 00 00 00 00 00 00 00 00 00 00 00 00 00 02 01 00 00 00 00 00 00 00 00 00 00 00 00 00 00 03 12 04 04 04 04 04 04 04 04
04 04 04 04 04 04 04 04 11 03 00 00 00 00 00 00 00 00 00 00 00 00 00 00 02 01 00 00 00 00 00 00 00 00 00 00 00 00 00 00 03 12 04 04 04 04 04 04 04 04
04 04 04 04 04 04 04 04 11 03 00 00 00 00 00 00 00 00 00 00 00 00 00 00 02 01 00 00 00 00 00 00 00 00 00 00 00 00 00 00 03 12 04 04 04 04 04 04 04 04
04 04 04 04 04 04 04 04 11 03 00 00 00 00 00 00 00 00 00 00 00 00 00 00 02 01 00 00 00 00 00 00 00 00 00 00 00 00 00 00 03 12 04 04 04 04 04 04 04 04
04 04 04 04 04 04 04 04 11 03 00 00 00 00 00 00 00 00 00 00 00 00 00 00 02 01 00 00 00 00 00 00 00 00 00 00 00 00 00 00 03 12 04 04 04 04 04 04 04 04
04 04 04 04 04 04 04 04 11 03 00 00 00 00 00 00 00 00 00 00 00 00 00 00 02 01 00 00 00 00 00 00 00 00 00 00 00 00 00 00 03 12 04 04 04 04 04 04 04 04
04 04 04 04 04 04 04 04 11 03 00 00 00 00 00 00 00 00 00 00 00 00 00 00 02 01 00 00 00 00 00 00 00 00 00 00 00 00 00 00 03 12 04 04 04 04 04 04 04 04
04 04 04 04 04 04 04 04 11 03 00 00 00 00 00 00 00 00 00 00 00 00 00 00 02 01 00 00 00 00 00 00 00 00 00 00 00 00 00 00 03 12 04 04 04 04 04 04 04 04
04 04 04 04 04 04 04 04 11 03 00 00 00 00 00 00 00 00 00 00 00 00 00 00 02 01 00 00 00 00 00 00 00 00 00 00 00 00 00 00 03 12 04 04 04 04 04 04 04 04
04 04 04 04 04 04 04 04 11 03 00 00 00 00 00 00 00 00 00 00 00 00 00 00 02 01 00 00 00 00 00 00 00 00 00 00 00 00 00 00 03 12 04 04 04 04 04 04 04 04
04 04 04 04 04 04 04 04 11 03 00 00 00 00 00 00 00 00 00 00 00 00 00 00 02 01 00 00 00 00 00 00 00 00 00 00 00 00 00 00 03 12 04 04 04 04 04 04 04 04
04 04 04 04 04 04 04 04 11 03 00 00 00 00 00 00 00 00 00 00 00 00 00 00 02 01 00 00 00 00 00 00 00 00 00 00 00 00 00 00 03 12 04 04 04 04 04 04 04 04
04 04 04 04 04 04 04 04 11 03 00 00 00 00 00 00 00 00 00 00 00 00 00 00 02 01 00 00 00 00 00 00 00 00 00 00 00 00 00 00 03 12 04 04 04 04 04 04 04 04
04 04 04 04 04 04 04 04 11 03 00 00 00 00 00 00 00 00 00 00 00 00 00 00 02 01 00 00 00 00 00 00 00 00 00 00 00 00 00 00 03 12 04 04 04 04 04 04 04 04
04 04 04 04 04 04 04 04 11 03 00 00 00 00 00 00 00 00 00 00 00 00 00 00 02 01 00 00 00 00 00 00 00 00 00 00 00 00 00 00 03 12 04 04 04 04 04 04 04 04
04 04 04 04 04 04 04 04 11 03 00 00 00 00 00 00 00 00 00 00 00 00 00 00 02 01 00 00 00 00 00 00 00 00 00 00 00 00 00 00 03 12 04 04 04 04 04 04 04 04
04 04 04 04 04 04 04 04 11 03 00 00 00 00 00 00 00 00 00 00 00 00 00 00 02 01 00 00 00 00 00 00 00 00 00 00 00 00 00 00 03 12 04 04 04 04 04 04 04 04
04 04 04 04 04 04 04 04 11 03 00 00 00 00 00 00 00 00 00 00 00 00 00 00 02 01 00 00 00 00 00 00 00 00 00 00 00 00 00 00 03 12 04 04 04 04 04 04 04 04
04 04 04 04 04 04 04 04 11 03 00 00 00 00 00 00 00 00 00 00 00 00 00 00 02 01 00 00 00 00 00 00 00 00 00 00 00 00 00 00 03 12 04 04 04 04 04 04 04 04
04 04 04 04 04 04 04 04 11 03 00 00 00 00 00 00 00 00 00 00 00 00 00 00 02 01 00 00 00 00 00 00 00 00 00 00 00 00 00 00 03 12 04 04 04 04 04 04 04 04
04 04 04 04 04 04 04 04 11 03 00 00 00 00 00 00 00 00 00 00 00 00 00 00 00 00 00 00 00 00 00 00 00 00 00 00 00 00 00 00 03 12 04 04 04 04 04 04 04 04
04 04 04 04 04 04 04 04 11 03 03 03 03 03 03 03 03 03 03 03 03 03 03 03 03 03 03 03 03 03 03 03 03 03 03 03 03 03 03 03 03 12 04 04 04 04 04 04 04 04
04 04 04 04 04 04 04 04 05 07 07 07 07 07 07 07 07 07 07 07 07 07 07 07 07 07 07 07 07 07 07 07 07 07 07 07 07 07 07 07 07 06 04 04 04 04 04 04 04 04
04 04 04 04 04 04 04 04 04 04 04 04 04 04 04 04 04 04 04 04 04 04 04 04 04 04 04 04 04 04 04 04 04 04 04 04 04 04 04 04 04 04 04 04 04 04 04 04 04 04
04 04 04 04 04 04 04 04 04 04 04 04 04 04 04 04 04 04 04 04 04 04 04 04 04 04 04 04 04 04 04 04 04 04 04 04 04 04 04 04 04 04 04 04 04 04 04 04 04 04
04 04 04 04 04 04 04 04 04 04 04 04 04 04 04 04 04 04 04 04 04 04 04 04 04 04 04 04 04 04 04 04 04 04 04 04 04 04 04 04 04 04 04 04 04 04 04 04 04 04
04 04 04 04 04 04 04 04 04 04 04 04 04 04 04 04 04 04 04 04 04 04 04 04 04 04 04 04 04 04 04 04 04 04 04 04 04 04 04 04 04 04 04 04 04 04 04 04 04 04
04 04 04 04 04 04 04 04 04 04 04 04 04 04 04 04 04 04 04 04 04 04 04 04 04 04 04 04 04 04 04 04 04 04 04 04 04 04 04 04 04 04 04 04 04 04 04 04 04 04
