22 22 22 22 22 22 22 22 22 22 22 22 22 22 22 22 22 22 22 22 22 22 22 22 22 22 22 22 22 22 22 22 22 22 22 22 22 22 22 22 22 22 22 22 22 22 22 22 22 22
22 22 22 22 22 22 22 22 22 22 22 22 22 22 22 22 22 22 22 22 22 22 22 22 22 22 22 22 22 22 22 22 22 22 22 22 22 22 22 22 22 22 22 22 22 22 22 22 22 22
22 22 22 22 22 22 22 22 22 22 22 22 22 22 22 22 22 22 22 22 22 22 22 22 22 22 22 22 22 22 22 22 22 22 22 22 22 22 22 22 22 22 22 22 22 22 22 22 22 22
22 22 22 22 22 22 22 22 22 22 22 22 22 22 22 22 22 22 22 22 22 22 22 22 22 22 22 22 22 22 22 22 22 22 22 22 22 22 22 22 22 22 22 22 22 22 22 22 22 22
22 22 22 22 22 22 22 22 22 22 22 22 22 22 22 22 22 22 22 22 22 22 22 22 22 22 22 22 22 22 22 22 22 22 22 22 22 22 22 22 22 22 22 22 22 22 22 22 22 22
22 22 22 22 22 22 22 22 22 22 22 22 22 22 22 22 22 22 22 22 22 22 22 22 22 22 22 22 22 22 22 22 22 22 22 22 22 22 22 22 22 22 22 22 22 22 22 22 22 22
22 22 22 22 22 22 22 22 22 22 22 22 22 22 22 22 22 22 22 22 22 22 22 22 22 22 22 22 22 22 22 22 22 22 22 22 22 22 22 22 22 22 22 22 22 22 22 22 22 22
22 22 22 22 22 22 22 22 22 22 22 22 22 22 22 22 22 22 22 22 22 22 22 22 22 22 22 22 22 22 22 22 22 22 22 22 22 22 22 22 22 22 22 22 22 22 22 22 22 22
22 22 22 22 22 22 22 22 22 22 22 22 22 22 22 22 22 22 22 22 22 22 22 24 24 24 22 22 22 22 22 22 22 22 22 22 22 22 22 22 22 22 22 22 22 22 22 22 22 22
22 22 22 22 22 22 22 22 22 22 22 22 22 22 22 22 24 24 24 24 24 24 24 24 25 24 24 24 24 24 24 24 24 22 22 22 22 22 22 22 22 22 22 22 22 22 22 22 22 22
22 22 22 22 22 22 22 22 22 22 22 22 22 22 22 22 24 26 26 26 26 26 26 26 26 26 26 26 26 26 26 26 24 22 22 22 22 22 22 22 22 22 22 22 22 22 22 22 22 22
22 22 22 22 22 22 22 22 22 22 22 22 22 22 22 22 24 26 26 26 26 26 26 26 26 26 26 26 26 26 26 26 24 22 22 22 22 22 22 22 22 22 22 22 22 22 22 22 22 22
22 22 22 22 22 22 22 22 22 22 22 22 22 22 22 22 24 26 26 26 26 26 26 26 26 26 26 26 26 26 26 26 24 22 22 22 22 22 22 22 22 22 22 22 22 22 22 22 22 22
22 22 22 22 22 22 22 22 22 22 22 22 22 22 22 22 24 26 26 26 26 26 26 26 26 26 26 26 26 26 26 26 24 22 22 22 22 22 22 22 22 22 22 22 22 22 22 22 22 22
22 22 22 22 22 22 22 22 22 22 22 22 22 22 22 22 24 26 26 26 26 26 26 26 26 26 26 26 26 26 26 26 24 22 22 22 22 22 22 22 22 22 22 22 22 22 22 22 22 22
22 22 22 22 22 22 22 22 22 22 22 22 22 22 22 22 24 26 26 26 26 26 26 26 26 26 26 26 26 26 26 26 24 22 22 22 22 22 22 22 22 22 22 22 22 22 22 22 22 22
22 22 22 22 22 22 22 22 22 22 22 22 22 22 22 22 24 26 26 26 26 26 26 26 26 26 26 26 26 26 26 26 24 22 22 22 22 22 22 22 22 22 22 22 22 22 22 22 22 22
22 22 22 22 22 22 22 22 22 22 22 22 22 22 22 22 24 26 26 26 26 26 26 26 26 26 26 26 26 26 26 26 24 22 22 22 22 22 22 22 22 22 22 22 22 22 22 22 22 22
22 22 22 22 22 22 22 24 24 24 24 24 24 24 24 22 24 26 26 26 26 26 26 26 26 26 26 26 26 26 26 26 24 22 24 24 24 24 24 24 24 24 22 22 22 22 22 22 22 22
22 22 22 22 22 22 22 24 26 26 26 26 26 26 24 24 24 26 26 26 26 26 26 26 26 26 26 26 26 26 26 26 24 24 24 26 26 26 26 26 26 24 22 22 22 22 22 22 22 22
22 22 22 22 22 22 22 24 26 26 26 26 26 26 26 26 26 26 26 26 26 26 26 26 26 26 26 26 26 26 26 26 26 26 26 26 26 26 26 26 26 24 22 22 22 22 22 22 22 22
22 22 22 22 22 22 22 24 26 26 26 26 26 26 24 24 24 26 26 26 26 26 26 26 26 26 26 26 26 26 26 26 24 24 24 26 26 26 26 26 26 24 22 22 22 22 22 22 22 22
22 22 22 22 22 22 22 24 26 26 26 26 26 26 24 22 24 26 26 26 26 26 26 26 26 26 26 26 26 26 26 26 24 22 24 26 26 26 26 26 26 24 22 22 22 22 22 22 22 22
22 22 22 22 22 22 22 24 26 26 26 26 26 26 24 22 24 26 26 26 26 26 26 26 26 26 26 26 26 26 26 26 24 22 24 26 26 26 26 26 26 24 22 22 22 22 22 22 22 22
22 22 22 22 22 22 22 24 24 24 24 24 26 24 24 22 24 26 26 26 26 26 26 26 26 26 26 26 26 26 26 26 24 22 24 24 26 24 24 24 24 24 22 22 22 22 22 22 22 22
22 22 22 22 22 22 22 22 22 22 22 24 26 24 22 22 24 24 24 24 24 24 24 26 26 26 24 24 24 24 24 24 24 22 22 24 26 24 22 22 22 22 22 22 22 22 22 22 22 22
22 22 22 22 22 22 22 22 22 22 22 24 26 24 22 22 22 22 22 22 22 22 24 24 26 24 24 22 22 22 22 22 22 22 22 24 26 24 22 22 22 22 22 22 22 22 22 22 22 22
22 22 22 22 22 22 22 22 22 22 22 24 26 24 22 22 22 22 22 22 22 22 22 24 26 24 22 22 22 22 22 22 22 22 22 24 26 24 22 22 22 22 22 22 22 22 22 22 22 22
22 22 22 22 22 22 22 22 22 22 22 24 26 24 22 22 22 22 22 22 24 24 24 24 26 24 24 24 24 24 22 22 22 22 22 24 26 24 22 22 22 22 22 22 22 22 22 22 22 22
22 22 22 22 22 22 22 22 22 24 24 24 26 24 24 24 24 22 22 24 26 26 26 26 26 26 26 26 26 24 22 22 24 24 24 24 26 24 24 24 22 22 22 22 22 22 22 22 22 22
22 22 22 22 22 22 22 22 22 24 26 26 26 26 26 26 24 22 24 24 26 26 26 26 26 26 26 26 26 24 24 22 24 26 26 26 26 26 26 24 22 22 22 22 22 22 22 22 22 22
22 22 22 22 22 22 22 22 22 24 26 26 26 26 26 26 24 24 24 26 26 26 26 26 24 26 26 26 26 26 24 24 24 26 26 26 26 26 26 24 22 22 22 22 22 22 22 22 22 22
22 22 22 22 22 22 22 22 22 24 26 26 26 26 26 26 26 26 26 26 26 26 26 24 24 24 26 26 26 26 26 26 26 26 26 26 26 26 26 24 22 22 22 22 22 22 22 22 22 22
22 22 22 22 22 22 22 22 22 24 26 26 26 26 26 26 24 24 24 26 26 26 26 24 24 24 26 26 26 26 24 24 24 26 26 26 26 26 26 24 22 22 22 22 22 22 22 22 22 22
22 22 22 22 22 22 22 22 22 24 26 26 26 26 26 26 24 22 24 24 26 26 26 26 24 26 26 26 26 24 24 22 24 26 26 26 26 26 26 24 22 22 22 22 22 22 22 22 22 22
22 22 22 22 22 22 22 22 22 24 24 24 24 24 24 24 24 22 22 24 26 26 26 26 26 26 26 26 26 24 22 22 24 24 24 24 24 24 24 24 22 22 22 22 22 22 22 22 22 22
22 22 22 22 22 22 22 22 22 22 22 22 22 22 22 22 22 22 22 24 24 24 26 26 26 26 26 24 24 24 22 22 22 22 22 22 22 22 22 22 22 22 22 22 22 22 22 22 22 22
22 22 22 22 22 22 22 22 22 22 22 22 22 22 22 22 22 22 22 22 22 24 26 26 26 26 26 24 22 22 22 22 22 22 22 22 22 22 22 22 22 22 22 22 22 22 22 22 22 22
22 22 22 22 22 22 22 22 22 22 22 22 22 22 22 22 22 22 22 22 22 24 24 26 26 26 24 24 22 22 22 22 22 22 22 22 22 22 22 22 22 22 22 22 22 22 22 22 22 22
22 22 22 22 22 22 22 22 22 22 22 22 22 22 22 22 22 22 22 22 22 22 24 24 26 24 24 22 22 22 22 22 22 22 22 22 22 22 22 22 22 22 22 22 22 22 22 22 22 22
22 22 22 22 22 22 22 22 22 22 22 22 22 22 22 22 22 22 22 22 22 22 22 24 24 24 22 22 22 22 22 22 22 22 22 22 22 22 22 22 22 22 22 22 22 22 22 22 22 22
22 22 22 22 22 22 22 22 22 22 22 22 22 22 22 22 22 22 22 22 22 22 22 22 22 22 22 22 22 22 22 22 22 22 22 22 22 22 22 22 22 22 22 22 22 22 22 22 22 22
22 22 22 22 22 22 22 22 22 22 22 22 22 22 22 22 22 22 22 22 22 22 22 22 22 22 22 22 22 22 22 22 22 22 22 22 22 22 22 22 22 22 22 22 22 22 22 22 22 22
22 22 22 22 22 22 22 22 22 22 22 22 22 22 22 22 22 22 22 22 22 22 22 22 22 22 22 22 22 22 22 22 22 22 22 22 22 22 22 22 22 22 22 22 22 22 22 22 22 22
22 22 22 22 22 22 22 22 22 22 22 22 22 22 22 22 22 22 22 22 22 22 22 22 22 22 22 22 22 22 22 22 22 22 22 22 22 22 22 22 22 22 22 22 22 22 22 22 22 22
22 22 22 22 22 22 22 22 22 22 22 22 22 22 22 22 22 22 22 22 22 22 22 22 22 22 22 22 22 22 22 22 22 22 22 22 22 22 22 22 22 22 22 22 22 22 22 22 22 22
22 22 22 22 22 22 22 22 22 22 22 22 22 22 22 22 22 22 22 22 22 22 22 22 22 22 22 22 22 22 22 22 22 22 22 22 22 22 22 22 22 22 22 22 22 22 22 22 22 22
22 22 22 22 22 22 22 22 22 22 22 22 22 22 22 22 22 22 22 22 22 22 22 22 22 22 22 22 22 22 22 22 22 22 22 22 22 22 22 22 22 22 22 22 22 22 22 22 22 22
22 22 22 22 22 22 22 22 22 22 22 22 22 22 22 22 22 22 22 22 22 22 22 22 22 22 22 22 22 22 22 22 22 22 22 22 22 22 22 22 22 22 22 22 22 22 22 22 22 22
22 22 22 22 22 22 22 22 22 22 22 22 22 22 22 22 22 22 22 22 22 22 22 22 22 22 22 22 22 22 22 22 22 22 22 22 22 22 22 22 22 22 22 22 22 22 22 22 22 22