04 04 04 04 04 04 04 04 04 04 04 04 04 04 04 04 04 04 04 04 04 04 04 04 04 04 04 04 04 04 04 04 04 04 04 04 04 04 04 04 04 04 04 04 04 04 04 04 04 04
04 04 04 04 04 04 04 04 04 04 04 04 04 04 04 04 04 04 04 04 04 04 04 04 04 04 04 04 04 04 04 04 04 04 04 04 04 04 04 04 04 04 04 04 04 04 04 04 04 04
04 04 04 04 04 04 04 04 04 04 04 04 04 04 04 04 04 04 04 04 04 04 04 04 04 04 04 04 04 04 04 04 04 04 04 04 04 04 04 04 04 04 04 04 04 04 04 04 04 04
04 04 04 04 04 04 04 04 04 04 04 04 04 04 04 04 04 04 04 04 04 04 04 04 04 04 04 04 04 04 04 04 04 04 04 04 04 04 04 04 04 04 04 04 04 04 04 04 04 04
04 04 04 04 04 04 04 04 04 04 04 04 04 04 04 04 04 04 04 04 04 04 04 04 04 04 04 04 04 04 04 04 04 04 04 04 04 04 04 04 04 04 04 04 04 04 04 04 04 04
04 04 04 04 04 04 04 04 08 10 10 10 10 10 10 10 10 10 10 10 10 10 10 10 10 10 10 10 10 10 10 10 10 10 10 10 10 10 10 10 10 09 04 04 04 04 04 04 04 04
04 04 04 04 04 04 04 04 11 03 03 03 03 03 03 03 03 03 03 03 03 03 03 03 03 03 03 03 03 03 03 03 03 03 03 03 03 03 03 03 03 12 04 04 04 04 04 04 04 04
04 04 04 04 04 04 04 04 11 03 19 15 15 15 15 15 15 15 15 15 15 15 15 15 15 15 15 15 15 15 15 15 15 15 15 15 15 15 15 20 03 12 04 04 04 04 04 04 04 04
04 04 04 04 04 04 04 04 11 03 14 00 00 00 00 00 00 00 00 00 00 00 00 00 29 30 00 00 00 00 00 00 00 00 00 00 00 00 00 13 03 12 04 04 04 04 04 04 04 04
04 04 04 04 04 04 04 04 11 03 14 00 00 21 21 00 00 00 00 00 00 00 00 00 29 30 00 00 21 21 00 00 00 00 00 00 00 00 00 13 03 12 04 04 04 04 04 04 04 04
04 04 04 04 04 04 04 04 11 03 14 00 00 21 21 00 00 00 00 00 00 00 00 00 29 30 00 00 21 21 00 00 00 00 00 00 00 00 00 13 03 12 04 04 04 04 04 04 04 04
04 04 04 04 04 04 04 04 11 03 14 00 00 00 00 00 00 00 00 00 00 00 00 00 29 30 00 00 00 00 00 00 00 00 00 00 00 00 00 13 03 12 04 04 04 04 04 04 04 04
04 04 04 04 04 04 04 04 11 03 14 00 00 00 00 00 00 00 00 00 00 00 00 00 29 30 00 00 00 00 00 00 00 00 00 00 00 00 00 13 03 12 04 04 04 04 04 04 04 04
04 04 04 04 04 04 04 04 11 03 14 00 00 00 00 00 00 00 00 00 00 00 00 00 29 30 00 00 00 00 00 00 00 00 00 21 21 00 00 13 03 12 04 04 04 04 04 04 04 04
04 04 04 04 04 04 04 04 11 03 14 00 00 00 00 00 00 00 00 00 00 00 00 00 29 30 00 00 00 00 00 00 00 00 00 21 21 00 00 13 03 12 04 04 04 04 04 04 04 04
04 04 04 04 04 04 04 04 11 03 14 00 00 00 00 00 00 00 00 00 00 00 00 00 29 30 00 00 00 00 00 00 00 00 00 00 00 00 00 13 03 12 04 04 04 04 04 04 04 04
04 04 04 04 04 04 04 04 11 03 14 00 00 00 00 00 00 00 00 00 00 00 00 00 29 30 00 00 00 00 21 21 00 00 00 00 00 00 00 13 03 12 04 04 04 04 04 04 04 04
04 04 04 04 04 04 04 04 11 03 14 00 00 00 00 00 00 00 00 00 00 00 00 00 29 30 00 00 00 00 21 21 00 00 00 00 00 00 00 13 03 12 04 04 04 04 04 04 04 04
04 04 04 04 04 04 04 04 11 03 14 00 00 00 00 00 00 00 00 00 00 00 00 00 29 30 00 00 00 00 00 00 00 00 00 00 00 00 00 13 03 12 04 04 04 04 04 04 04 04
04 04 04 04 04 04 04 04 11 03 14 00 00 00 00 00 00 00 00 00 00 00 00 00 29 30 00 00 00 00 00 00 00 00 00 00 00 00 00 13 03 12 04 04 04 04 04 04 04 04
04 04 04 04 04 04 04 04 11 03 14 00 00 00 00 00 00 00 00 00 00 00 00 00 29 30 00 00 00 00 00 00 00 00 00 00 00 00 00 13 03 12 04 04 04 04 04 04 04 04
04 04 04 04 04 04 04 04 11 03 14 27 27 27 27 27 27 27 27 27 27 27 27 27 36 34 27 27 27 27 27 27 27 27 27 27 27 27 27 13 03 12 04 04 04 04 04 04 04 04
04 04 04 04 04 04 04 04 11 03 14 28 28 28 28 28 28 28 28 28 28 28 28 28 37 35 28 28 28 28 28 28 28 28 28 28 28 28 28 13 03 12 04 04 04 04 04 04 04 04
04 04 04 04 04 04 04 04 11 03 14 00 00 00 00 00 00 00 00 00 00 00 00 00 29 30 00 00 00 00 00 00 21 21 00 00 00 00 00 13 03 12 04 04 04 04 04 04 04 04
04 04 04 04 04 04 04 04 11 03 14 00 00 00 00 00 00 00 00 00 00 00 00 00 29 30 00 00 00 00 00 00 21 21 00 00 00 00 00 13 03 12 04 04 04 04 04 04 04 04
04 04 04 04 04 04 04 04 11 03 14 00 00 00 00 00 00 00 00 00 00 00 00 00 29 30 00 00 00 00 00 00 00 00 00 00 00 00 00 13 03 12 04 04 04 04 04 04 04 04
04 04 04 04 04 04 04 04 11 03 14 00 00 00 21 21 00 00 00 00 00 00 00 00 29 30 00 21 21 00 00 00 00 00 00 00 00 00 00 13 03 12 04 04 04 04 04 04 04 04
04 04 04 04 04 04 04 04 11 03 14 00 00 00 21 21 00 00 00 00 00 00 00 00 29 30 00 21 21 00 00 00 00 00 00 00 00 00 00 13 03 12 04 04 04 04 04 04 04 04
04 04 04 04 04 04 04 04 11 03 14 00 00 00 00 00 00 00 00 00 00 00 00 00 29 30 00 00 00 00 00 00 00 00 00 21 21 00 00 13 03 12 04 04 04 04 04 04 04 04
04 04 04 04 04 04 04 04 11 03 14 00 00 00 00 00 00 00 00 00 00 00 00 00 29 30 00 00 00 00 00 00 00 00 00 21 21 00 00 13 03 12 04 04 04 04 04 04 04 04
04 04 04 04 04 04 04 04 11 03 14 00 00 00 00 00 00 00 00 00 00 00 00 00 29 30 00 00 00 00 00 00 00 00 00 00 00 00 00 13 03 12 04 04 04 04 04 04 04 04
04 04 04 04 04 04 04 04 11 03 14 00 00 00 00 00 00 00 00 00 00 00 00 00 29 30 00 00 00 00 00 00 00 00 00 00 00 00 00 13 03 12 04 04 04 04 04 04 04 04
04 04 04 04 04 04 04 04 11 03 14 00 00 00 00 00 00 00 00 00 00 00 00 00 29 30 00 00 00 00 00 00 00 00 00 00 00 00 00 13 03 12 04 04 04 04 04 04 04 04
04 04 04 04 04 04 04 04 11 03 14 00 00 00 00 00 00 00 00 00 00 00 00 00 29 30 00 00 00 00 00 00 00 00 00 00 00 00 00 13 03 12 04 04 04 04 04 04 04 04
04 04 04 04 04 04 04 04 11 03 14 00 00 00 00 00 00 00 00 00 00 00 00 00 29 30 00 00 00 21 21 00 00 00 00 00 00 00 00 13 03 12 04 04 04 04 04 04 04 04
04 04 04 04 04 04 04 04 11 03 14 00 00 00 00 00 00 00 00 00 00 00 00 00 29 30 00 00 00 21 21 00 00 00 00 00 00 00 00 13 03 12 04 04 04 04 04 04 04 04
04 04 04 04 04 04 04 04 11 03 14 00 00 00 00 00 00 00 00 00 21 21 00 00 29 30 00 00 00 00 00 00 00 00 00 00 00 00 00 13 03 12 04 04 04 04 04 04 04 04
04 04 04 04 04 04 04 04 11 03 14 00 00 00 00 00 00 00 00 00 21 21 00 00 29 30 00 00 00 00 00 00 00 00 21 21 00 00 00 13 03 12 04 04 04 04 04 04 04 04
04 04 04 04 04 04 04 04 11 03 14 00 21 21 00 00 00 00 00 00 00 00 00 00 29 30 00 00 00 00 00 00 00 00 21 21 00 00 00 13 03 12 04 04 04 04 04 04 04 04
04 04 04 04 04 04 04 04 11 03 14 00 21 21 00 00 00 00 00 00 00 00 00 00 29 30 00 00 00 00 00 00 00 00 00 00 00 00 00 13 03 12 04 04 04 04 04 04 04 04
04 04 04 04 04 04 04 04 11 03 14 00 00 00 00 00 00 00 00 00 00 00 00 00 29 30 00 00 00 00 00 00 00 00 00 00 00 00 00 13 03 12 04 04 04 04 04 04 04 04
04 04 04 04 04 04 04 04 11 03 17 16 16 16 16 16 16 16 16 16 16 16 16 16 16 16 16 16 16 16 16 16 16 16 16 16 16 16 16 18 03 12 04 04 04 04 04 04 04 04
04 04 04 04 04 04 04 04 11 03 03 03 03 03 03 03 03 03 03 03 03 03 03 03 03 03 03 03 03 03 03 03 03 03 03 03 03 03 03 03 03 12 04 04 04 04 04 04 04 04
04 04 04 04 04 04 04 04 05 07 07 07 07 07 07 07 07 07 07 07 07 07 07 07 07 07 07 07 07 07 07 07 07 07 07 07 07 07 07 07 07 06 04 04 04 04 04 04 04 04
04 04 04 04 04 04 04 04 04 04 04 04 04 04 04 04 04 04 04 04 04 04 04 04 04 04 04 04 04 04 04 04 04 04 04 04 04 04 04 04 04 04 04 04 04 04 04 04 04 04
04 04 04 04 04 04 04 04 04 04 04 04 04 04 04 04 04 04 04 04 04 04 04 04 04 04 04 04 04 04 04 04 04 04 04 04 04 04 04 04 04 04 04 04 04 04 04 04 04 04
04 04 04 04 04 04 04 04 04 04 04 04 04 04 04 04 04 04 04 04 04 04 04 04 04 04 04 04 04 04 04 04 04 04 04 04 04 04 04 04 04 04 04 04 04 04 04 04 04 04
04 04 04 04 04 04 04 04 04 04 04 04 04 04 04 04 04 04 04 04 04 04 04 04 04 04 04 04 04 04 04 04 04 04 04 04 04 04 04 04 04 04 04 04 04 04 04 04 04 04
04 04 04 04 04 04 04 04 04 04 04 04 04 04 04 04 04 04 04 04 04 04 04 04 04 04 04 04 04 04 04 04 04 04 04 04 04 04 04 04 04 04 04 04 04 04 04 04 04 04
