04 04 04 04 04 04 04 04 04 04 04 04 04 04 04 04 04 04 04 04 04 04 04 04 04 04 04 04 04 04 04 04 04 04 04 04 04 04 04 04 04 04 04 04 04 04 04 04 04 04
04 04 04 04 04 04 04 04 04 04 04 04 04 04 04 04 04 04 04 04 04 04 04 04 04 04 04 04 04 04 04 04 04 04 04 04 04 04 04 04 04 04 04 04 04 04 04 04 04 04
04 04 04 04 04 04 04 04 04 04 04 04 04 04 04 04 04 04 04 04 04 04 04 04 04 04 04 04 04 04 04 04 04 04 04 04 04 04 04 04 04 04 04 04 04 04 04 04 04 04
04 04 04 04 04 04 04 04 04 04 04 04 04 04 04 04 04 04 04 04 04 04 04 04 04 04 04 04 04 04 04 04 04 04 04 04 04 04 04 04 04 04 04 04 04 04 04 04 04 04
04 04 04 04 04 04 04 04 04 04 04 04 04 04 04 04 04 04 04 04 04 04 04 04 04 04 04 04 04 04 04 04 04 04 04 04 04 04 04 04 04 04 04 04 04 04 04 04 04 04
04 04 04 04 04 04 04 04 08 10 10 10 10 10 10 10 10 10 10 10 10 10 10 10 10 10 10 10 10 10 10 10 10 10 10 10 10 10 10 10 10 09 04 04 04 04 04 04 04 04
04 04 04 04 04 04 04 04 11 03 03 03 03 03 03 03 03 03 03 03 03 03 03 03 03 03 03 03 03 03 03 03 03 03 03 03 03 03 03 03 03 12 04 04 04 04 04 04 04 04
04 04 04 04 04 04 04 04 11 03 19 15 15 15 15 15 15 15 15 15 15 15 15 15 15 15 15 15 15 15 15 15 15 15 15 15 15 15 15 20 03 12 04 04 04 04 04 04 04 04
04 04 04 04 04 04 04 04 11 03 14 00 00 00 00 00 00 00 00 00 00 00 00 00 29 30 00 00 00 00 00 00 00 00 00 00 00 00 00 13 03 12 04 04 04 04 04 04 04 04
04 04 04 04 04 04 04 04 11 03 14 00 00 00 00 00 00 00 00 00 00 00 00 00 29 30 00 00 21 21 00 00 00 00 00 00 00 00 00 13 03 12 04 04 04 04 04 04 04 04
04 04 04 04 04 04 04 04 11 03 14 22 22 22 22 21 21 21 00 22 22 22 22 00 29 30 00 00 21 21 00 00 00 00 00 00 00 00 00 13 03 12 04 04 04 04 04 04 04 04
04 04 04 04 04 04 04 04 11 03 14 00 00 00 22 00 21 00 00 22 00 00 22 00 29 30 00 00 00 00 00 00 00 00 00 00 00 00 00 13 03 12 04 04 04 04 04 04 04 04
04 04 04 04 04 04 04 04 11 03 14 00 00 00 22 00 00 00 00 22 22 22 22 00 29 30 00 00 00 00 00 00 00 00 00 00 00 00 00 13 03 12 04 04 04 04 04 04 04 04
04 04 04 04 04 04 04 04 11 03 14 22 22 22 22 00 00 00 00 22 21 21 22 00 29 30 00 00 00 00 00 00 00 00 00 21 21 00 00 13 03 12 04 04 04 04 04 04 04 04
04 04 04 04 04 04 04 04 11 03 14 21 21 00 22 22 22 22 00 22 00 00 22 00 29 30 00 00 00 00 00 00 00 00 00 21 21 00 00 13 03 12 04 04 04 04 04 04 04 04
04 04 04 04 04 04 04 04 11 03 14 00 21 00 22 00 00 22 00 22 22 22 22 00 29 30 00 00 00 00 00 00 00 00 00 00 00 00 00 13 03 12 04 04 04 04 04 04 04 04
04 04 04 04 04 04 04 04 11 03 14 00 21 21 22 00 00 22 22 22 21 21 22 00 29 30 00 00 00 00 21 21 00 00 00 00 00 00 00 13 03 12 04 04 04 04 04 04 04 04
04 04 04 04 04 04 04 04 11 03 14 00 21 00 22 00 21 21 22 22 00 00 22 00 29 30 00 00 00 00 21 21 00 00 00 00 00 00 00 13 03 12 04 04 04 04 04 04 04 04
04 04 04 04 04 04 04 04 11 03 14 00 22 22 22 00 21 21 00 22 22 22 22 00 29 30 00 00 00 00 00 00 00 00 00 00 00 00 00 13 03 12 04 04 04 04 04 04 04 04
04 04 04 04 04 04 04 04 11 03 14 00 00 00 00 00 22 22 22 22 00 22 22 00 29 30 00 00 00 00 00 00 00 00 00 00 00 00 00 13 03 12 04 04 04 04 04 04 04 04
04 04 04 04 04 04 04 04 11 03 14 00 00 00 00 00 00 00 00 00 00 00 00 00 29 30 00 00 00 00 00 00 00 00 00 00 00 00 00 13 03 12 04 04 04 04 04 04 04 04
04 04 04 04 04 04 04 04 11 03 14 27 27 27 27 27 27 27 27 27 27 27 27 27 36 34 27 27 27 27 27 27 27 27 27 27 27 27 27 13 03 12 04 04 04 04 04 04 04 04
04 04 04 04 04 04 04 04 11 03 14 28 28 28 28 28 28 28 28 28 28 28 28 28 37 35 28 28 28 28 28 28 37 35 28 28 28 28 28 13 03 12 04 04 04 04 04 04 04 04
04 04 04 04 04 04 04 04 11 03 14 00 21 00 00 21 00 21 00 00 00 00 21 00 29 30 00 00 00 00 00 00 29 30 00 00 00 00 00 13 03 12 04 04 04 04 04 04 04 04
04 04 04 04 04 04 04 04 11 03 14 00 00 00 21 00 21 38 00 21 00 21 00 00 29 30 00 00 00 00 00 00 29 30 00 00 00 00 00 13 03 12 04 04 04 04 04 04 04 04
04 04 04 04 04 04 04 04 11 03 14 00 00 00 00 00 38 38 38 00 00 00 00 21 29 30 00 00 00 00 00 00 29 30 00 00 00 00 00 13 03 12 04 04 04 04 04 04 04 04
04 04 04 04 04 04 04 04 11 03 14 00 00 00 00 38 38 38 38 38 21 00 00 00 29 30 00 21 21 00 00 00 29 30 00 00 00 00 00 13 03 12 04 04 04 04 04 04 04 04
04 04 04 04 04 04 04 04 11 03 14 00 21 21 00 00 38 38 38 00 00 00 21 00 29 30 00 21 21 00 00 00 29 30 00 00 00 00 00 13 03 12 04 04 04 04 04 04 04 04
04 04 04 04 04 04 04 04 11 03 14 00 21 21 00 21 21 38 00 21 00 21 00 00 29 30 00 00 00 00 00 00 29 30 00 21 21 00 00 13 03 12 04 04 04 04 04 04 04 04
04 04 04 04 04 04 04 04 11 03 14 00 00 00 00 21 00 00 00 00 00 00 00 00 29 30 00 00 00 00 00 00 29 30 00 21 21 00 00 13 03 12 04 04 04 04 04 04 04 04
04 04 04 04 04 04 04 04 11 03 14 27 27 27 27 27 27 27 27 27 27 27 27 27 36 34 27 27 27 27 27 27 36 34 27 27 27 27 27 13 03 12 04 04 04 04 04 04 04 04
04 04 04 04 04 04 04 04 11 03 14 28 28 28 28 28 28 28 28 28 28 28 28 28 37 35 28 28 28 28 28 28 37 35 28 28 28 28 28 13 03 12 04 04 04 04 04 04 04 04
04 04 04 04 04 04 04 04 11 03 14 00 00 00 00 00 00 00 00 00 00 00 00 00 29 30 00 00 00 00 00 00 29 30 00 00 00 00 00 13 03 12 04 04 04 04 04 04 04 04
04 04 04 04 04 04 04 04 11 03 14 00 00 00 00 00 00 00 00 00 00 00 00 00 29 30 00 00 00 00 00 00 29 30 00 00 00 00 00 13 03 12 04 04 04 04 04 04 04 04
04 04 04 04 04 04 04 04 11 03 14 00 00 00 00 00 00 00 00 00 00 00 00 00 29 30 00 00 00 21 21 00 29 30 00 00 00 00 00 13 03 12 04 04 04 04 04 04 04 04
04 04 04 04 04 04 04 04 11 03 14 00 00 00 00 00 00 00 00 00 00 00 00 00 29 30 00 00 00 21 21 00 29 30 00 00 00 00 00 13 03 12 04 04 04 04 04 04 04 04
04 04 04 04 04 04 04 04 11 03 14 00 00 00 00 00 00 00 00 00 21 21 00 00 29 30 00 00 00 00 00 00 29 30 00 00 00 00 00 13 03 12 04 04 04 04 04 04 04 04
04 04 04 04 04 04 04 04 11 03 14 00 00 00 00 00 00 00 00 00 21 21 00 00 29 30 00 00 00 00 00 00 29 30 21 21 00 00 00 13 03 12 04 04 04 04 04 04 04 04
04 04 04 04 04 04 04 04 11 03 14 00 21 21 00 00 00 00 00 00 00 00 00 00 29 30 00 00 00 00 00 00 29 30 21 21 00 00 00 13 03 12 04 04 04 04 04 04 04 04
04 04 04 04 04 04 04 04 11 03 14 00 21 21 00 00 00 00 00 00 00 00 00 00 29 30 00 00 00 00 00 00 29 30 00 00 00 00 00 13 03 12 04 04 04 04 04 04 04 04
04 04 04 04 04 04 04 04 11 03 14 00 00 00 00 00 00 00 00 00 00 00 00 00 29 30 00 00 00 00 00 00 29 30 00 00 00 00 00 13 03 12 04 04 04 04 04 04 04 04
04 04 04 04 04 04 04 04 11 03 17 16 16 16 16 16 16 16 16 16 16 16 16 16 16 16 16 16 16 16 16 16 16 16 16 16 16 16 16 18 03 12 04 04 04 04 04 04 04 04
04 04 04 04 04 04 04 04 11 03 03 03 03 03 03 03 03 03 03 03 03 03 03 03 03 03 03 03 03 03 03 03 03 03 03 03 03 03 03 03 03 12 04 04 04 04 04 04 04 04
04 04 04 04 04 04 04 04 05 07 07 07 07 07 07 07 07 07 07 07 07 07 07 07 07 07 07 07 07 07 07 07 07 07 07 07 07 07 07 07 07 06 04 04 04 04 04 04 04 04
04 04 04 04 04 04 04 04 04 04 04 04 04 04 04 04 04 04 04 04 04 04 04 04 04 04 04 04 04 04 04 04 04 04 04 04 04 04 04 04 04 04 04 04 04 04 04 04 04 04
04 04 04 04 04 04 04 04 04 04 04 04 04 04 04 04 04 04 04 04 04 04 04 04 04 04 04 04 04 04 04 04 04 04 04 04 04 04 04 04 04 04 04 04 04 04 04 04 04 04
04 04 04 04 04 04 04 04 04 04 04 04 04 04 04 04 04 04 04 04 04 04 04 04 04 04 04 04 04 04 04 04 04 04 04 04 04 04 04 04 04 04 04 04 04 04 04 04 04 04
04 04 04 04 04 04 04 04 04 04 04 04 04 04 04 04 04 04 04 04 04 04 04 04 04 04 04 04 04 04 04 04 04 04 04 04 04 04 04 04 04 04 04 04 04 04 04 04 04 04
04 04 04 04 04 04 04 04 04 04 04 04 04 04 04 04 04 04 04 04 04 04 04 04 04 04 04 04 04 04 04 04 04 04 04 04 04 04 04 04 04 04 04 04 04 04 04 04 04 04
